-------------------------------------------------------------------------------------------------------------------------------------------------------
-------------------------------------------------------------------------------------------------------------------------------------------------------
-------------------------------------------------------------------------------------------------------------------------------------------------------
-----------------------------------------------------------SLSSSSSSSSSSSSSSSSSSSSSS-----------------------------LSSSSSSSSSSSSSSSSSSSSSSSSSSSSSSSSSSS---
-------------------------------------------------------------------------SSS---------------------------------------------------------------SSS---------
-----------------y--%------------------------------------k---------------SSS---------------------------------------------------------------SSS---------
-----------------##---------S-----------US---------------#-oo-------------SS-------------S-------------S--------o-------------------------S------------
----------------###------------------------------S-------#----------------SS--------------------------------------------------------------S------------
--------------g####--------------------------------------#-SS-------------SS------------------------------------S-------------------------S------------
--------------#####--------------------------------------#-SS------------oSS---------SSS----SSS-----------------S-------------------------S------------
--------TTTTTT#####-----------t--------####----------SSS-#---------------SSS------Q----------------------SSUSC-------------------------g#-SSSS-#-------
--------TTTTTT#####-----------t------####--------SSS-----#----#--------------------------K---------------------------------------------##--SSS-#-------
--------TTTTTT#####-----------t-----###------------------#----#-------------------------------------tt-----------------#--------------###--SSS-#-#-----
--M-----TTTTTT#####-----------t-----##-------------------#----#---k-g------g----g-----------o-------tt--K-------------##--------------###------#-#---F-
XXXXXXXXXXXXXXXXXXXX%%%%%--X%XXXXXXX-----XX------X---XXXXXXXXXXXXXXXXXXXXXXXXXXXXXX-X---XXXX%---XXXXXXXXXXXXXXXXXXXXXXXXXXXXX------XXXXXXXXXXXXXXXX--XX
XXXXXXXXXXXXXXXXXXXX|-||---X-XXXXXXX-----XX------X---XXXXXXXXXXXXXXXXXXXXXXXXXXXXXX-X---XXXX----XXXXXXXXXXXXXXXXXXXXXXXXXXXXX------XXXXXXXXXXXXXXXX--XX

