-------------------------------------------------------------------------------------------------------------------------------------------------------
----------------------------------------------------------------S--------------------------------------------------------------------------------------
-------------------------------------------------------S-S------S----------------------------------S---------------------------------------------------
----------------------o-o---S-------SSSSSS--S-SSSSS--SSSSS-SSSS--SSS---------------SSS-----------SSSSSS----SSSS-SSSSSSSSSSSSSSS----------SS------------
------------------------o------S----SSSSSSSS------------S--SSSSSS-SS--------------------o--------SSSSSSS--%SSSSSS--------------------------------------
--------------------------------g---SSSS-S-S------------S---SSSS-----------#-----------oo-------SSSSSSS---|SSSSS----------------------K----------------
------------------Q---S-S-----S-S---S----S-------------------S------------###-------------------SSSSSSS---|-S-SS----------------------r----------------
-------------------------------------o---S-U------------------------------##--------T---------------------|-S-------------------------Y----------------
----------------------------y-------ooo-SSUU--------------------------k--###--------T-----------r---------|-S-S-----------------------k##--------------
---------------------------gr-------ooooooo------------------ooUU-----y-####--------T-----------g-S-------|oS-SUU---------------------g#---%-----------
-------2----------?--------TT-------oSSSSS----------------T-SSSS-------#####------CCT--SSSSS----ySSSSSSoo-|SSSSSS--k##------QQQQQQ----##-----------S---
------T--------------------TT----------S---------k---TTTT-T-------S-########--------T---S-SS--K-SSSSSSS-r-|--------###---TT-----------##-tt------------
------T--------------------TT---TTT%-----------------TTTT-T-------S-########---y-#--T-----S-----SSSSSSS%%%|------#####---TT-----------##-tt-----S------
--M---T---%%-%-------------TT---TTT|-kkk---------#--kTTTT-T--k---S---#######---##--kT-----------SSSSSSS||%|-------####---TT-----------#--tt----------F-
XXXXXXXXX--%%%%%XXXXXX---XXXXXXXXXX|XXXXXXXXXXXXXXXXXXXXXXXXXXXXXSX-XXXXXXXXXXXXXXXXXX-------XXXXXXXXXX||%|XXXXXXXXXXXXXXXXXXXXXXX----XXXXX---XX-----XX
XXXXXXXXX||||||-XXXXXX---XXXXXXXXXX|XXXXXXXXXXXXXXXXXXXXXXXXXXXXX-X-XXXXXXXXXXXXXXXXXX-------XXXXXXXXXX||-|XXXXXXXXXXXXXXXXXXXXXXX----XXXXX---XX-----XX