-------------------------------------------------------------------------------------------------------------------------------------------------------
-------------------------------------------------------------------------------------------------------------------------------------------------------
----------------------------------S----------------S--------------------------------------------------------------------------------------SS-----------
----------------------------------SSSSSSSS--------SSSS-S----------------SSSSS-SSSSSSSSSSSS--------SSSSSSSSSSSS--SSSSSSSSSSSSSSSSSSSSSSSS-SSSSSSSSSSS---
------------------------------------S------------------------------------S--------SSS-------------S---S----------------SS----SSSSSSSS------SSSSSSSS----
--------C----------U----------------------------%o--------------------------------SSS----------%%-S--------------------------SSSSSSSS-------SSSSSS-----
--------------QQ---US---------------------------%%------------C------------------SS------------|--S---------------------------S----SS-------S---SS-----
----------------------------------S--------------|------r-----C------------------S-------------|--S---------------------------S----SS-------S---SS-----
--------------------------------U----------------|------%-------g----------------S-------------|--S--------------------------------SS-------S---SS-----
-----------gggy----------------UU-S----------2---|------|---U---#----------------S-------------|--S-------------C-------------SooooSS-------SoooSS-----
-----------#g#SQ--S-------------------##--%------|TTTTTT|--SUSSS#---------------SSSS--QQQQ-----|--S---------------------------SS-SSSS-------SS-SSS-----
-------------#------------------------##---------|TTTTTT|-------#---------#-------SSS----------|--------------------##-----------------##--------------
------------------------------y-------##---------|TTTTTT%-------#-----g--##-------SSS-------#--|------tt------------##-----------------#---------------
--M---------------ggg----S-SSSS---g-#-##-------g-|TTTTTT|-----k-#----gg-###-----------------#--|--g---tt-g------E----#------g----k--g--#--g---k--g-gyF-
XXXXXXXXXXX----XXXXXXXXXX-----XXXXXXXXXXXX-XXXXXX%XXXXXX|XXXXXXXXXXXXXXXXXXXXXXXXXXXXXXXXX--XXX|-XXXXXXXXXXXX--XXXXX-X-----XXXXXXXXXXXXXXXXXXXXXXXXX-XX
XXXXXXXXXXX----XXXXXXXXXX-----XXXXXXXXXXXX-XXXXXX|XXXXXX|XXXXXXXXXXXXXXXXXXXXXXXXXXXXXXXXX--XXX|-XXXXXXXXXXXX--XXXXX-X-----XXXXXXXXXXXXXXXXXXXXXXXXX-XX

